'#','#','#','#','#','#','#','#','#','#','#','#','#','#','#','#'
'#','.','.','.','.','.','.','.','.','.','.','.','.','.','.','#' 
'#','.','#','#','#','#','.','.','#','#','#','.','#','.','.','#' 
'#','.','#','.','.','#','.','.','#','.','#','.','#','.','.','#' 
'#','.','#','.','.','#','@','.','#','.','#','.','#','.','.','#' 
'#','.','#','.','.','#','#','#','#','.','#','#','#','.','.','#' 
'#','.','#','.','.','#','.','.','.','.','.','.','.','.','.','#' 
'#','.','.','.','.','.','.','.','.','#','#','.','.','.','.','#' 
'#','.','.','.','.','.','.','.','.','#','#','.','.','.','.','#' 
'#','#','#','#','#','#','#','#','#','#','#','#','#','#','.','#' 
	   