'#','#','#','#','#','#','#','#','#','#','#','#','#','#','#','#''#','#','#','.','#',
'#','.','.','.','#','.','.','.','.','.','#','.','.','.','.','.','.','.','#','.','#' 
'#','.','.','.','#','.','.','.','.','.','#','.','.','.','.','.','.','.','#','.','#' 
'#','.','#','#','#','.','.','#','.','.','.','.','#','.','.','#','.','.','#','.','#' 
'#','.','#','.','#','.','.','#','#','.','.','.','#','.','.','#','.','.','#','.','#' 
'#','.','#','.','#','.','.','.','#','#','#','#','#','.','.','#','#','#','#','.','#' 
'#','.','#','.','.','.','.','.','.','#','.','.','#','.','.','#','.','.','.','.','#' 
'#','.','.','.','.','.','.','.','.','#','.','.','#','.','.','#','.','.','.','.','#' 
'#','.','.','.','#','#','.','.','#','#','.','.','#','.','.','#','.','.','#','.','#'
'#','.','#','.','.','.','.','.','.','.','.','.','.','.','.','.','.','.','#','.','#' 
'#','.','#','.','.','.','.','.','.','.','.','.','.','.','.','.','.','.','#','.','#' 
'#','.','#','#','#','#','#','#','#','#','#','#','#','.','.','#','#','#','#','.','#' 
'#','.','.','.','.','.','.','.','.','.','.','.','.','.','.','.','.','.','.','.','#' 
'#','.','.','.','.','.','.','.','.','.','.','.','.','.','.','.','.','.','.','.','#'  
'#','#','#','#','#','#','#','#','#','#','#','#','#','#','#','#','#','#','#','#','#' 
	   